

Tillgängliga kommandon i NiKom. Siffra inom parentes anger vilken status
som behövs för att utföra kommandot.

Kommandon i mötessystemet:
--------------------------
Addera Rättigheter     - Adderar rättigheter till ett slutet möte
Brev                   - Skickar ett personligt brev
Endast                 - Minskar/ökar antalet olästa texter i ett möte
Flytta Text            - Flyttar en text till ett annat möte
Gå                     - Går till ett annat möte
Hoppa Över             - Hoppar över kommentarer till en text
Igen                   - Visar den senast lästa texten igen
Inlägg                 - Skriver ett nytt inlägg
Kommentera             - Kommenterar den senast lästa texten
Lista Medlemmar        - Listar alla medlemmar i ett möte
Lista Möten            - Listar alla möten
Lista Nyheter          - Visar i vilka möten det finns olästa texter
Lista Rättigheter      - Listar vilka som får vara med i ett slutet möte
Lista Ärende           - Listar texterna i ett möte
Läsa                   - Läser en text
Markera Text           - Markerar en text för senare läsning
Medlem                 - Gör användaren till medlem i ett möte
Nästa Kommentar        - Läser nästa kommantar
Nästa Möte             - Går till nästa möte med olästa texter
Nästa Text             - Läser nästa text
Personlig              - Skickar en kommentar som ett brev
Radera Brev            - Raderar ett brev
Radera Möte            - Raderar ett möte
Radera Text            - Raderar en text
Skapa Möte             - Skapar ett nytt möte
Skriv                  - Skriver en ny text
Subtrahera Rättigheter - Subtraherar rättigheter i ett slutet möte
Utträd                 - Går ur ett möte
Var                    - Visar vilket möte man befinner sig i
Visa Markerade         - Visar texter markerade med 'Markera Text'
Återse Kommentar       - Visar texten som senaste texten är kommentar till
Ändra Möte             - Ändrar uppgifter om ett möte


Filkommandon
------------
Areor                  - Listar alla filareor
Byt Area               - Byter aktuell area
Download               - Laddar ner en fil från filarean
Filer                  - Listar alla filer i aktuell area
Filstatus              - Visar detaljerad information om en fil
Ladda Ner              - Laddar ner en fil från filarean
Ladda Upp              - Laddar upp en fil till filarean
Lista Areor            - Listar alla filareor
Lista Filer            - Listar alla filer i aktuell area
Lista Nycklar          - Listar alla söknycklar
Lista Privatfiler      - Listar alla filer i den privata filarean
Nya Filer              - Listar alla nya filer sedan förra inloggningen
Privat Download        - Laddar ner en fil från den privata filarean
Privat Upload          - Laddar upp en fil till en privat filarea
Radera Fil             - Raderar en fil ur filarean
Radera Privatfil       - Raderar en fil ur den privata filarean
Sök                    - Söker efter filer med angett attribut
Upload                 - Laddar upp en fil till filarean
Ändra Fil              - Ändrar uppgifter om en fil

Övriga kommandon:
-----------------
?                      - Visar en hjälptext
Exekvera Profile       - Kör den personliga profilen
Hjälp                  - Visar en hjälptext
Info                   - Ger information om olika saker
Lista Användare        - Listar alla registrerade användare
Lista Flaggor          - Listar alla personliga flaggor
Lista Kommandon        - Listar alla kommandon
Lista Senaste          - Listar de senast inloggade
Logout                 - Loggar ut ur basen och kopplar ned modemet
Manual                 - Visar detaljerad information om ett kommando
Radera Lapp            - Raderar den personliga lappen
Ropa                   - Ropar på sysop för ett samtal
Sluta                  - Loggar ut ur basen och kopplar ned modemet
Slå Av                 - Slår av en personlig flagga
Slå På                 - Slår på en personlig flagga
Status                 - Visar detaljerad information om en användare
SysInfo                - Ger information om systemet
Säg                    - Skickar ett meddelande till en annan nod
Tiden                  - Visar datum, klockslag och återstående tid
Vilka                  - Visar vilka som är inloggade på olika noder
Visa Profile           - Visar den personliga profilen
Ändra Användare        - Ändrar uppgifter om en användare
Ändra Lapp             - Ändrar den personliga lappen
Ändra Profile          - Ändrar den personliga profilen
